*S****************
*                *
* ******** *******
*    *   *     G**
**G***************